'CO': Continental Airlines
'US': US Airways
'AA': American Airlines
'AS': Alaska Airlines
'DL': Delta Airlines
'B6': JetBlue Airways
'HA': Hawaiian Airlines
'OO': SkyWest Airlines
'9E': Endeavor Air
'OH': PSA Airlines
'EV': ExpressJet Airlines
'XE': ExpressJet Airlines
'YV': Mesa Airlines
'UA': United Airlines
'MQ': Envoy Air
'FL': AirTran Airways
'F9': Frontier Airlines
'WN': Southwest Airlines

ATL - Hartsfield-Jackson Atlanta International Airport - Georgia
AUS - Austin-Bergstrom International Airport - Texas
BNA - Nashville International Airport - Tennessee
BOS - Boston Logan International Airport - Massachusetts
BWI - Baltimore-Washington International Thurgood Marshall Airport - Washington
CLT - Charlotte Douglas International Airport - North Carolina
DAL - Dallas Love Field - Texas
DCA - Ronald Reagan Washington National Airport - Arlington, Virginia
DEN - Denver International Airport - Colorado
DFW - Dallas/Fort Worth International Airport - Texas
DTW - Detroit Metropolitan Airport - Michigan
EWR - Newark Liberty International Airport - New Jersey
FLL - Fort Lauderdale–Hollywood International Airport - Florida
HNL - Daniel K. Inouye International Airport - Honolulu, Hawaii
HOU - William P. Hobby Airport - Houston, Texas
IAD - Dulles International Airport - Virginia
IAH - George Bush Intercontinental Airport - Houston, Texas
JFK - John F. Kennedy International Airport - Queens, New York
LAS - McCarran International Airport - Las Vegas, Nevada
LAX - Los Angeles International Airport - California
LGA - LaGuardia Airport - Queens, New York
MCO - Orlando International Airport - Florida
MDW - Chicago Midway International Airport - Illinois
MIA - Miami International Airport - Florida
MSP - Minneapolis–Saint Paul International Airport - Minnesota
MSY - Louis Armstrong New Orleans International Airport - Louisiana
OAK - Oakland International Airport - California
ORD - O'Hare International Airport - Chicago, Illinois
PDX - Portland International Airport - Oregon
PHL - Philadelphia International Airport - Pennsylvania
PHX - Phoenix Sky Harbor International Airport - Arizona
RDU - Raleigh-Durham International Airport - North Carolina
SAN - San Diego International Airport - California
SEA - Seattle–Tacoma International Airport - Washington
SFO - San Francisco International Airport - California
SJC - Norman Y. Mineta San Jose International Airport - California
SLC - Salt Lake City International Airport - Utah
SMF - Sacramento International Airport - California
STL - St. Louis Lambert International Airport - Missouri
TPA - Tampa International Airport - Florida